EEEWEEEEEEWEEE
E2EWEEEEEEWEEE
EgEWEEEEEEW1EE
EEEWEEEEEEWEEE
WWWGEEEEEEWEEE
EEEEEEEEEEWYWE
EEEEEEEEEEEEEE
EEEEEEEEEEEEEE
EEEEEEEEEEEEEE
EEEEEEEEEEWWWW
EEEEEEEEEEWE2E
EEEEEEEEEEW12E
EEEEEEEEEEWE2E
EEEEEEEEEEW444
EEEEEEEEWWWWWW
EEEEEEEEWWWgyr
EEEEEEEE***EEE