ETEEEEEE*EEEEEEEEEEE
r12yGEETEE2rEEEREEEE
RE3EEEGGEE1EgEEGRYEE
EEEErETEERREEEEEE*EE
EEEE3EEYYEE2EyEEEEEE
EEE*EE2E111EEEEEEEEE
EEEEEETEEEEgryEEEEEE
