EEyEWEEEEEEEEEEWE2E
3EgEWEEEEEEEEEEW433
ErEEWEEEEEEEEEEWEE4
RWWWWEEEEEEEEEEWWYW
EEEEEEEEEEEEEEEEEEE
EEEEEEEEEEEEEEEEEEE
WWWWEEEEE4EEEEEEEEE
EgEWEEE3EEEEEEEEEEE
EEEWE2EEEEEEEEEWWWW
EEE*EE2EEEEEEEG23rE