EWWWWWWWWWWWWWE
EEEEEEEE1E2E3EW
EWWWWWWWWWWWWWW
EEEEE1E2E3E4EE*
WWWWWWWWWWWWWWR
EEEEEEEEE**EEEE
rEEEEEEEEEEEEEE
EEEEEEEEEEEEEEE
EEEEEEEEEEEEEEE
EEEEEEEEEEEEEgE