ETREWE2E2EEEEEE2EEEE
ETEEWEE3EEEEEEEEEEEE
3EEEWEEEEEEEEEEE3EEE
WWWWrEEEEEEEE23EEEEE
EEEEE2EEEEEEEEEEEEEE
EEEEEEEEEEEEEEEEEEEE
EEEEEEEEEEEEEEEEEEEE
EEEEEEEEEEEEEEEEEEEE
EEEEEEEEEEEEEEEEEEEE
EEEEEEEEEEEEEEEEEEEE
EEEEEEEEEEEEEEEEEEEE
EEEEEEEEEEEEEEEEEEEE
EEEEEEEEEEEEEEEEEEEE
EEEEEEEEEEEE2EEEEEEE
EEEEEEEEEEEEEEEEEEEE
EEEEEEEEEEEEEEEEEEEE
EEEEE1EEEEEEEEEEEEEE
EEEEEEEEEEEE1EEEEEEE
EEEEEEEEEEEE3TEEEEEE
EE33EEEEEEEEEEEEEEEE