EEEEEEEEEEEEEEE
E422EEEEEEEEEEE
E4E2EEEEEEEEEEE
E4EEEEEEEEEEEEE
EEEEEEEEEEEEEEE
EEEEEEEEEEEEEEE
EEEEEEEEEEEEEEE
EEEEEEEEEEEEEEE
EEEEEEEEEEE311E
EEEEEEEEEEE3E1E
EEEEEEEEEEE3EEE
