EEEE3EEE3EEE3EETEEEE
EE2EEEEEEE1EEE1234EE
EEEE4EEEEEEEEEEEEEEE
TEEEEEEEEEEEEEEEEEEE
WWWWWWWWWWWWWWWWWW*G
WWWWWWTWWWWWWWWWWW*R
WWWWWWTWWWWWWWWWWW*Y
WWWWWWWWWWWWWWWWWW*E
EEEEEEEEEEEEEEEEEEEE
EEyEEEEEEEEEEEEETEEE
EEEEEEEEEErEEEEEEEEE
ETEEEEEEEEEEEEEEEEgE