EEEEEW111EE222E
EEEEEW111EE2222
EEEEEW111EE2222
EEEEEWEE1EE3333
EEEEEWEEEEEE222
EEEEEWEEEEEEE33
EEEEEWEEEEEE443
EEEEEWEEEEEEEEE
EEEEEWEEEEEEEEE
EEEEEWEE11EEEEE
EEEEEWEE11EEEEE
EEEEEWEEE1EEEEE
EEEEEWEE11EEEEE
EEEEEE11EEEEEEE