E1WEEEEEEEEEEEEEW2E
1*WEEEEEEEEEEEEEW*2
WWWEEWWWWEEEEEEEWWW
EEEEEW3*WEEEEEEEEEE
WWWEEW43WEEEEEEEWWW
3*WEEWWWWEEEEEEEW*2
E3WEEEEEEEEEEEEEW2E
