EE4EE4EE4EE4EEE
WWWWWWWWWWWWWWE
E2E2EE2EE2EE2E2
2WWWWWWWWWWWWWW
E1E1E1E1E1E1E1E
WWWWWWWWWWWWWW1
E3EE3EE3EE3EE3E
EWWWWWWWWWWWWWE
