EEEEEEEEEEEEEEE3EEE
EEEEE4EEEEEEEEE4TEE
EEEEEEEEEE4EEEEEEEE
******WWWWWWWWEEEEE
EEEEEEWEEEEETWEEEEE
ETE1EEWErEEEEWEEEEE
******WWWWWWWWWWWWW
EEEEEEEEEEEEWEE2EEE
EEETEEEEEEEEWEE3EEE
EEEEEEEEEEEEREEEE2E