EE2TWy*EEEREEEE*EEEE
EEETWEEEEEY2ERREEEEg
EE*TWE*ErEEE*3EREE3E
TTTEWEEEEGEE1WEEEEW2
WWWRWYEEWEEE2EEEE2WE
EEREEErEEEEEEGE3E*E1
1EEEErEEEEEEEEEEEEWE
EEEEETEEEEEEEERYEEYE
3REE1EEEEEEEW332EEEE
ErEEEEEEEGEEE3EEEEEE
EEEE1EEEEEEEGE3EEEYW
GEEWEEEEEWE3EEEEE1E3
2E2EEREEEEE3EEWEEEE1
EEWEGE*EEEEEEEE31EE*
EEE*EWEEEEGEEEEEEWEE
REEEEEERE*EEREE1EEYE
2EEEEEREEEEE1E1EEEEW
EEREE3EE3EEEEEEEEEEE
EEEEEEEEEEEGEE3E32EE
EEEEEEEEY*EEEEREEREE