ETEEEEEE*EEEEEEEEEEE
E12yGEETEE2rEEEREEEE
EE3EEEGGEE1EgEEGRYEE
EEEErETEERREEEEEE*EE
EEEE3EEYYEE2EyEEEEEE
EEE*EE2E111EEEEEEEEE
EEEEEETEEEEgryEEEEEE
