EWWWWWWWWWWWWWWWWWWWWE
41E*EEEEEEEEEEEEEEEWgE
32EWEEEEEEEEEEEEEEEW33
23EWEEEEEEEEEEEEEEEWEE
WWWWEEEEEEEEEEEEEEE*WW
EEEEEEEEEEEEEEEEEEEEEE
WWWGEEEEEEEEEEEEEEE123
23EWEEEEEEEEEEEEEEEEEE
32EWEEEEEEEEEEEEEEEEEE
41EWEEEEEEEEEEEEEEEEEE
WWWWEEEEEEEEEEEEEEEEEE
EEEEEEEEEEEEEEEEEEEEEE