EWEEWEEEWEEEEEE
EWEEWWWEWEE1EEE
EWE1EE1EWEEE1EE
EEEEWWWEWEEE1EE
EEEEWEEEWE1EEEE
WWWWW1EEWE1EEEE
EEEEEEEEWEE1EEE
EEEE1EE1WEEE1EE
EEEEE1EEW2222EE
EEEE1EEEWWWWWWW
EEEEEEEEE2EEEEE
EEE222EEEEEEEEE
EEE333EEEEEEEEE
EEE111EEEEEEEEE