EEEEEE11EW4***E
WWWWWWW1WWWWWWW
2EEEEEE1EEEEE*2
1EEEEEEEEEEEEEE
111EEEEEEEEEEEE
111EEEEEEEEEEEE
EEEEEEEEEEEEEEE
