E*EEEEEEEEEEEEEEEEE
*2222222EEEEEEEEEEE
EE2EEEE2EEEEEEEEEEE
EE2EEEE2EEEEEWWWWWW
EE2EEEE2222EEW*111*
EE2EEEEEEE2EEW*111*
EE222222222EEWWWWWE
