EEEEWE3EEEEEEEE
EEEEWEEEEE2EEEE
EEEEWEEEEEEEEEE
WWWWWEEEEEEEEEE
EE3EEEEEEEEE11E
EEEEEEEEEEEEEEE

