E12EEEEEEEEEEEE
EEEWE2EEEEEEEEE
E1EE1EEE1EEEEEE
EEEE1EEE2EEEEEE
EEWE*E2EE*EEEEE
EE1EE22EEEEEEEE
EEWE1EE22*EEEEE
EEEE*EEE222EEEE
EEE11EEWWWWWWWW
EEWEEEEWEE1111E
EE11EEEWEEEEEEE
EEWEEEEWEE2222E
EE11EEEWEEEEEEE
EWWE1EEWEE3333E