EEEWEEEEEEWE1E
EEEWEEEEEEWErE
*WWWEEEEEEGWWW
EEEEEEEEEEEEEE
EEEgEEEEEEEEEE
WWWWEEEEEEEWWW
2EyREEEEEEEYE3
EEEWEEEEEEEWEE