EEEE3EEE3EEE3EEEEEEE
EE2EEEEEEE1EEE1234EE
EEEE4EEEEEEEEEEEEEEE
EEEEEEEEEEEEEEEEEEEE
WWWWWWWWWWWWWWWWWW*G
WWWWWWWWWWWWWWWWWW*R
WWWWWWWWWWWWWWWWWW*Y
WWWWWWWWWWWWWWWWWW*E
EEEEEEEEEEEEEEEEEEEE
EEyEEEEEEEEEEEEEEEEE
EEEEEEEEEErEEEEEEEEE
EEEEEEEEEEEEEEEEEEgE