EEEEEEEEEEEEEEEEEEE
EEEEE3EEEEEEE334EEE
EEEEEEEEE3EEEEEEEEE
EE4EEEEEEEEEEEEEEEE
EEEEEEEEEEEEE2EEEEE
EEEEEEEEE123EEEEEEE
EgEEEEEEEEEEEEEEEEE
EEEEEEEEEEEEEEEEEEE
WWWWWWWWWWGWWWWWWWW
W*WEEEEEEEEEEEEEEEE
EEWEEEEEEEEEEEEEEEE
1EWEEEEEEEEEEEEEEEE
EgWEEEEEEEEEEEEEEEE
WWWEWWWWWWYWWWWWWWW
EEEEEEEEEEEEW334EEE
WWWWWWWEEEEEW234EEE
gEEEEEGEEEEEW134EEE
EEEEEEWEEEEEW334EEE
EEEE21WEEEyEW3E4EEE
