EEEEEEEEEEEEEEE3EEE
EEEEE4EEEEEEEEE4EEE
EEEEEEEEEE4EEEEEEEE
******WWWWWWWWEEEEE
EEEEEEW2EE1EEWEEEEE
EEE1EEWE2E2EEWEEEEE
******WWWWWWWWEEEEE
EEEEEEEEEEEEEEE2EEE
EEEEEEEEEEEEEEE3EEE
EEEEEEEEEEEEEEEEE2E