EEEEEEEEEEEEEE
EEEEEEEEEEEEEE
EEEEWWWWWWEEEE
EEEEWEEEEEEEEE
EEEEWEEEEEEEEE
EEEEW*WWWWEEEE
EEEEWEE4EWEEEE
EEEEWE2EEWEEEE
EEEEWWWWWWEEEE
EEEEEEEEEEEEEE